+-+-----+---+
|G|     |   |
| |  ++   | |
| |  ++ +-+ |
|       |   |
+-------+ | |
|S        | |
+---------+-+